"","year","county","POP_F_TOTAL","POP_M_TOTAL","TOTAL.POP","UCR_AG_ASSLT","UCR_ARSON","UCR_BURGLARY","UCR_MURDER","UCR_MVT","UCR_RAPE","UCR_ROBBERY","UCR_THEFT","UCR_TOTAL"
"1",2000,"ADAMS",8033,8395,16428,21,7,161,0,34,14,5,429,671
"2",2001,"ADAMS",8116,8484,16600,25,10,109,0,42,12,7,490,695
"3",2002,"ADAMS",8115,8485,16600,16,8,173,0,49,5,4,575,830
"4",2003,"ADAMS",8115,8485,16600,22,8,226,0,77,16,4,700,1053
"5",2004,"ADAMS",8165,8535,16700,41,8,265,0,50,9,11,624,1008
"6",2005,"ADAMS",8310,8690,17000,29,7,158,1,64,14,13,505,791
"7",2006,"ADAMS",8455,8845,17300,24,5,172,1,49,7,1,591,850
"8",2007,"ADAMS",8601,8999,17600,26,9,255,2,72,9,4,675,1052
"9",2008,"ADAMS",8697,9103,17800,43,5,183,0,82,9,5,631,958
"10",2009,"ADAMS",8795,9205,18000,31,10,185,1,75,6,19,525,852
"11",2010,"ADAMS",8943,9357,18300,37,6,229,1,72,8,10,566,929
"12",2011,"ADAMS",9292,9658,18950,39,9,209,0,65,4,10,537,873
"13",2012,"ADAMS",9475,9575,19050,0,0,0,0,0,0,0,0,0
"14",2013,"ADAMS",9439,9761,19200,0,0,0,0,0,0,0,0,0
"15",2014,"ADAMS",9518,9882,19400,0,0,0,0,0,0,0,0,0
"16",2000,"ASOTIN",10753,9798,20551,28,2,125,1,41,9,5,686,897
"17",2001,"ASOTIN",10830,9870,20700,41,15,189,0,31,7,11,709,1003
"18",2002,"ASOTIN",10831,9869,20700,31,1,163,0,44,16,2,603,860
"19",2003,"ASOTIN",10780,9820,20600,36,4,172,0,50,6,4,581,853
"20",2004,"ASOTIN",10833,9867,20700,41,7,129,1,57,5,1,554,795
"21",2005,"ASOTIN",10938,9962,20900,30,4,60,1,48,6,7,504,660
"22",2006,"ASOTIN",11042,10058,21100,28,1,84,0,43,2,0,440,598
"23",2007,"ASOTIN",11145,10155,21300,27,3,72,0,34,1,5,434,576
"24",2008,"ASOTIN",11196,10204,21400,32,0,82,1,12,2,4,471,604
"25",2009,"ASOTIN",11247,10253,21500,39,0,102,0,33,3,7,425,609
"26",2010,"ASOTIN",11352,10348,21700,28,4,89,1,13,8,2,469,614
"27",2011,"ASOTIN",11179,10471,21650,34,2,110,0,14,0,2,533,695
"28",2012,"ASOTIN",11157,10543,21700,0,0,0,0,0,0,0,0,0
"29",2013,"ASOTIN",11185,10615,21800,0,0,0,0,0,0,0,0,0
"30",2014,"ASOTIN",11212,10738,21950,0,0,0,0,0,0,0,0,0
"31",2000,"BENTON",71690,70785,142475,246,62,885,2,285,52,51,3849,5432
"32",2001,"BENTON",72826,71974,144800,255,65,889,2,398,43,59,4406,6117
"33",2002,"BENTON",74211,73389,147600,239,43,958,4,417,42,55,3691,5449
"34",2003,"BENTON",76204,75396,151600,306,44,1056,4,259,45,47,3732,5493
"35",2004,"BENTON",77943,77157,155100,278,71,1226,5,351,46,60,4159,6196
"36",2005,"BENTON",79420,78680,158100,298,50,1038,7,447,49,49,4289,6227
"37",2006,"BENTON",80644,79956,160600,368,44,1026,3,340,47,53,3840,5721
"38",2007,"BENTON",81773,81127,162900,287,44,847,3,297,61,56,3401,4996
"39",2008,"BENTON",83057,82443,165500,279,43,902,1,274,75,60,3145,4779
"40",2009,"BENTON",84949,84351,169300,299,49,761,0,267,73,52,3234,4735
"41",2010,"BENTON",86747,86153,172900,277,33,792,3,251,49,54,3357,4816
"42",2011,"BENTON",89031,88869,177900,301,58,995,3,316,57,54,3686,5470
"43",2012,"BENTON",90068,89932,180000,0,0,0,0,0,0,0,0,0
"44",2013,"BENTON",91722,91678,183400,0,0,0,0,0,0,0,0,0
"45",2014,"BENTON",93222,93278,186500,0,0,0,0,0,0,0,0,0
"46",2000,"CHELAN",33458,33158,66616,82,10,461,1,161,39,22,2262,3038
"47",2001,"CHELAN",33685,33415,67100,100,10,604,3,162,27,18,2553,3477
"48",2002,"CHELAN",33928,33672,67600,93,12,526,1,131,28,34,2399,3224
"49",2003,"CHELAN",34073,33827,67900,67,17,560,4,124,44,32,2261,3109
"50",2004,"CHELAN",34319,34081,68400,89,23,570,2,173,46,26,2562,3491
"51",2005,"CHELAN",34712,34488,69200,97,12,485,2,162,35,18,2303,3114
"52",2006,"CHELAN",35155,34945,70100,79,8,366,1,127,20,27,2071,2699
"53",2007,"CHELAN",35695,35505,71200,77,10,377,1,124,34,23,1942,2588
"54",2008,"CHELAN",36139,35961,72100,80,3,332,3,121,36,15,1632,2222
"55",2009,"CHELAN",36384,36216,72600,96,11,322,2,105,26,24,1694,2280
"56",2010,"CHELAN",36734,36566,73300,68,3,325,2,103,34,14,1626,2175
"57",2011,"CHELAN",36434,36266,72700,80,4,386,5,108,13,25,1488,2109
"58",2012,"CHELAN",36712,36488,73200,0,0,0,0,0,0,0,0,0
"59",2013,"CHELAN",36877,36723,73600,0,0,0,0,0,0,0,0,0
"60",2014,"CHELAN",37253,37047,74300,0,0,0,0,0,0,0,0,0
"61",2000,"CLALLAM",32471,31708,64179,54,10,355,1,65,18,11,1505,2019
"62",2001,"CLALLAM",32598,31856,64454,64,21,434,2,92,27,16,1688,2344
"63",2002,"CLALLAM",32816,32084,64900,68,23,468,0,131,12,22,1412,2136
"64",2003,"CLALLAM",33013,32287,65300,78,19,489,0,106,21,10,1533,2256
"65",2004,"CLALLAM",33309,32591,65900,103,24,398,3,127,47,16,1289,2007
"66",2005,"CLALLAM",33751,33049,66800,91,45,488,0,193,53,13,1645,2528
"67",2006,"CLALLAM",34243,33557,67800,105,27,491,2,155,48,18,1733,2579
"68",2007,"CLALLAM",34580,33920,68500,114,19,381,1,120,51,16,1484,2186
"69",2008,"CLALLAM",34918,34282,69200,110,27,374,3,83,54,23,1426,2100
"70",2009,"CLALLAM",35060,34440,69500,129,13,403,3,76,53,28,1272,1977
"71",2010,"CLALLAM",35358,34742,70100,135,10,482,1,81,28,28,1524,2289
"72",2011,"CLALLAM",36071,35529,71600,134,12,507,2,117,30,22,1579,2403
"73",2012,"CLALLAM",36284,35716,72000,0,0,0,0,0,0,0,0,0
"74",2013,"CLALLAM",36459,35891,72350,0,0,0,0,0,0,0,0,0
"75",2014,"CLALLAM",36503,35997,72500,0,0,0,0,0,0,0,0,0
"76",2000,"CLARK",173908,171330,345238,633,163,2278,5,1056,104,212,9044,13495
"77",2001,"CLARK",177568,175032,352600,704,127,2259,10,856,108,188,9939,14191
"78",2002,"CLARK",182968,180432,363400,452,96,2409,3,1385,163,249,9067,13824
"79",2003,"CLARK",187430,184870,372300,531,89,2781,4,2010,201,225,11151,16992
"80",2004,"CLARK",192938,190362,383300,571,100,2696,12,1981,189,212,10719,16480
"81",2005,"CLARK",197014,194486,391500,528,76,2736,12,1908,219,239,10084,15802
"82",2006,"CLARK",202998,200502,403500,508,118,2366,5,1612,215,196,8584,13604
"83",2007,"CLARK",208733,206267,415000,550,129,2058,9,1640,208,224,8207,13025
"84",2008,"CLARK",213317,210883,424200,539,107,1868,2,1945,206,236,8136,13039
"85",2009,"CLARK",216805,214395,431200,562,94,1830,8,1460,228,235,7741,12158
"86",2010,"CLARK",218999,216601,435600,554,100,2074,1,1460,195,240,8579,13203
"87",2011,"CLARK",216726,211275,428001,519,73,2034,13,1323,171,258,8046,12437
"88",2012,"CLARK",218333,212917,431250,0,0,0,0,0,0,0,0,0
"89",2013,"CLARK",220438,215062,435500,0,0,0,0,0,0,0,0,0
"90",2014,"CLARK",224171,218629,442800,0,0,0,0,0,0,0,0,0
"91",2000,"COLUMBIA",2082,1982,4064,5,0,41,0,12,0,0,128,186
"92",2001,"COLUMBIA",2099,2001,4100,7,0,31,0,9,0,0,174,221
"93",2002,"COLUMBIA",2099,2001,4100,4,0,30,1,7,0,0,138,180
"94",2003,"COLUMBIA",2099,2001,4100,3,1,37,0,2,1,0,141,185
"95",2004,"COLUMBIA",2099,2001,4100,8,0,29,0,4,0,0,180,221
"96",2005,"COLUMBIA",2098,2002,4100,2,0,24,0,4,0,1,111,142
"97",2006,"COLUMBIA",2097,2003,4100,1,0,31,0,9,0,0,122,163
"98",2007,"COLUMBIA",2097,2003,4100,2,1,33,0,6,0,0,138,180
"99",2008,"COLUMBIA",2097,2003,4100,2,0,29,0,7,0,0,170,208
"100",2009,"COLUMBIA",2097,2003,4100,2,0,26,0,12,0,0,120,160
"101",2010,"COLUMBIA",2122,2028,4150,3,2,50,0,7,0,1,136,199
"102",2011,"COLUMBIA",2065,2035,4100,6,0,42,0,5,1,0,132,186
"103",2012,"COLUMBIA",2056,2044,4100,0,0,0,0,0,0,0,0,0
"104",2013,"COLUMBIA",2049,2051,4100,0,0,0,0,0,0,0,0,0
"105",2014,"COLUMBIA",2043,2037,4080,0,0,0,0,0,0,0,0,0
"106",2000,"COWLITZ",46898,46050,92948,216,67,1052,1,398,34,60,3448,5276
"107",2001,"COWLITZ",47362,46538,93900,273,70,1165,1,443,50,58,4080,6140
"108",2002,"COWLITZ",47603,46797,94400,244,55,1221,4,506,40,69,3903,6042
"109",2003,"COWLITZ",47848,47052,94900,276,41,1548,4,763,45,61,4291,7029
"110",2004,"COWLITZ",48041,47259,95300,248,34,1336,5,614,51,61,4020,6369
"111",2005,"COWLITZ",48330,47570,95900,184,54,1466,3,599,66,55,3877,6304
"112",2006,"COWLITZ",48770,48030,96800,137,43,1224,7,526,79,68,3522,5606
"113",2007,"COWLITZ",49260,48540,97800,148,28,953,3,369,84,64,3060,4709
"114",2008,"COWLITZ",49855,49145,99000,139,42,736,2,333,94,62,2741,4149
"115",2009,"COWLITZ",50151,49449,99600,121,41,819,1,389,56,40,2690,4157
"116",2010,"COWLITZ",50349,49651,100000,171,25,795,2,274,106,48,2535,3956
"117",2011,"COWLITZ",52003,50697,102700,166,74,677,4,302,86,59,2436,3804
"118",2012,"COWLITZ",52192,50858,103050,0,0,0,0,0,0,0,0,0
"119",2013,"COWLITZ",52342,50958,103300,0,0,0,0,0,0,0,0,0
"120",2014,"COWLITZ",52561,51139,103700,0,0,0,0,0,0,0,0,0
"121",2000,"DOUGLAS",16448,16155,32603,33,11,254,1,56,9,4,750,1118
"122",2001,"DOUGLAS",16540,16260,32800,39,5,302,0,54,14,0,860,1274
"123",2002,"DOUGLAS",16688,16412,33100,24,1,219,1,65,9,3,1014,1336
"124",2003,"DOUGLAS",16937,16663,33600,27,4,271,0,51,15,1,887,1256
"125",2004,"DOUGLAS",17235,16965,34200,37,1,237,1,59,12,4,969,1320
"126",2005,"DOUGLAS",17482,17218,34700,47,1,275,0,72,9,10,951,1365
"127",2006,"DOUGLAS",17980,17720,35700,62,7,263,1,60,10,13,1056,1472
"128",2007,"DOUGLAS",18276,18024,36300,55,7,229,2,60,9,11,954,1327
"129",2008,"DOUGLAS",18624,18376,37000,49,5,185,2,48,14,7,787,1097
"130",2009,"DOUGLAS",18923,18677,37600,50,7,274,0,49,10,7,838,1235
"131",2010,"DOUGLAS",19375,19125,38500,25,3,107,0,36,8,9,526,714
"132",2011,"DOUGLAS",19339,19311,38650,31,3,195,1,43,13,8,707,1001
"133",2012,"DOUGLAS",19470,19430,38900,0,0,0,0,0,0,0,0,0
"134",2013,"DOUGLAS",19659,19621,39280,0,0,0,0,0,0,0,0,0
"135",2014,"DOUGLAS",19830,19870,39700,0,0,0,0,0,0,0,0,0
"136",2009,"GARFIELD",1132,1118,2250,3,0,16,0,4,0,0,36,59
"137",2000,"FERRY",3496,3764,7260,5,1,30,2,6,0,0,50,94
"138",2001,"FERRY",3513,3787,7300,3,2,33,0,6,0,0,38,82
"139",2002,"FERRY",3513,3787,7300,9,0,25,0,2,0,0,40,76
"140",2003,"FERRY",3511,3789,7300,4,0,19,0,2,0,0,31,56
"141",2004,"FERRY",3510,3790,7300,2,0,9,1,2,4,0,28,46
"142",2005,"FERRY",3556,3844,7400,5,0,14,0,3,1,0,21,44
"143",2006,"FERRY",3603,3897,7500,4,0,10,0,4,2,0,30,50
"144",2007,"FERRY",3624,3926,7550,4,0,11,1,2,0,0,26,44
"145",2008,"FERRY",3693,4007,7700,8,0,16,1,2,0,0,20,47
"146",2009,"FERRY",3739,4061,7800,6,0,7,0,0,1,0,14,28
"147",2010,"FERRY",3761,4089,7850,8,0,15,0,4,0,0,23,50
"148",2011,"FERRY",3668,3932,7600,5,0,15,0,1,0,0,21,42
"149",2012,"FERRY",3678,3972,7650,0,0,0,0,0,0,0,0,0
"150",2013,"FERRY",3684,3966,7650,0,0,0,0,0,0,0,0,0
"151",2014,"FERRY",3690,3970,7660,0,0,0,0,0,0,0,0,0
"152",2000,"FRANKLIN",23595,25752,49347,83,8,357,3,129,13,35,1245,1873
"153",2001,"FRANKLIN",24087,26313,50400,80,6,341,5,153,13,35,1262,1895
"154",2002,"FRANKLIN",24509,26791,51300,114,1,338,2,153,17,32,1320,1977
"155",2003,"FRANKLIN",25604,27996,53600,72,7,326,1,136,23,20,1321,1906
"156",2004,"FRANKLIN",27225,29775,57000,105,7,434,3,161,15,38,1488,2251
"157",2005,"FRANKLIN",28893,31607,60500,62,6,480,0,239,20,33,1582,2422
"158",2006,"FRANKLIN",30656,33544,64200,119,16,464,3,212,22,36,1371,2243
"159",2007,"FRANKLIN",32181,35219,67400,85,10,463,0,289,31,45,1295,2218
"160",2008,"FRANKLIN",33515,36685,70200,112,25,525,1,184,20,47,1155,2069
"161",2009,"FRANKLIN",34710,37990,72700,151,25,373,1,182,35,48,1195,2010
"162",2010,"FRANKLIN",36049,39451,75500,139,30,374,3,136,28,41,1159,1910
"163",2011,"FRANKLIN",38831,41669,80500,173,16,428,2,187,30,33,1185,2054
"164",2012,"FRANKLIN",39919,42581,82500,0,0,0,0,0,0,0,0,0
"165",2013,"FRANKLIN",41110,43690,84800,0,0,0,0,0,0,0,0,0
"166",2014,"FRANKLIN",42057,44543,86600,0,0,0,0,0,0,0,0,0
"167",2000,"GARFIELD",1211,1186,2397,6,0,21,0,6,2,0,63,98
"168",2001,"GARFIELD",1212,1188,2400,6,1,19,0,2,0,0,46,74
"169",2002,"GARFIELD",1211,1189,2400,6,1,14,0,4,1,0,51,77
"170",2003,"GARFIELD",1210,1190,2400,2,0,13,0,3,3,0,80,101
"171",2004,"GARFIELD",1210,1190,2400,6,0,8,0,1,3,0,56,74
"172",2005,"GARFIELD",1209,1191,2400,5,1,9,0,7,1,0,73,96
"173",2006,"GARFIELD",1208,1192,2400,7,0,13,0,9,2,0,48,79
"174",2007,"GARFIELD",1183,1167,2350,3,0,10,0,1,0,0,37,51
"175",2008,"GARFIELD",1157,1143,2300,2,0,20,0,2,0,0,34,58
"176",2010,"GARFIELD",1158,1142,2300,0,1,11,0,0,3,0,43,58
"177",2011,"GARFIELD",1140,1110,2250,3,1,13,0,2,1,0,47,67
"178",2012,"GARFIELD",1150,1100,2250,0,0,0,0,0,0,0,0,0
"179",2013,"GARFIELD",1143,1107,2250,0,0,0,0,0,0,0,0,0
"180",2014,"GARFIELD",1138,1102,2240,0,0,0,0,0,0,0,0,0
"181",2000,"GRANT",36521,38177,74698,157,23,699,3,174,40,36,2341,3473
"182",2001,"GRANT",37094,38806,75900,139,20,746,0,262,42,31,2429,3669
"183",2002,"GRANT",37327,39073,76400,131,27,826,3,277,55,38,2704,4061
"184",2003,"GRANT",37662,39438,77100,118,45,853,3,225,48,29,2523,3844
"185",2004,"GRANT",38240,40060,78300,112,21,930,3,306,31,33,2886,4322
"186",2005,"GRANT",38619,40481,79100,139,25,1192,3,334,43,43,2907,4686
"187",2006,"GRANT",39337,41263,80600,109,16,1210,2,404,33,55,3251,5080
"188",2007,"GRANT",40256,42244,82500,140,35,1119,2,322,41,42,3072,4773
"189",2008,"GRANT",41276,43324,84600,171,26,1152,6,265,29,54,2802,4505
"190",2009,"GRANT",42008,44092,86100,151,22,1044,10,320,41,65,2550,4203
"191",2010,"GRANT",42793,44907,87700,166,29,1227,3,333,34,44,2765,4601
"192",2011,"GRANT",44175,45925,90100,189,12,986,6,238,21,35,2534,4021
"193",2012,"GRANT",44662,46338,91000,0,0,0,0,0,0,0,0,0
"194",2013,"GRANT",45072,46728,91800,0,0,0,0,0,0,0,0,0
"195",2014,"GRANT",45639,47261,92900,0,0,0,0,0,0,0,0,0
"196",2000,"GRAYS HARBOR",33804,33390,67194,82,16,652,5,171,26,10,2286,3248
"197",2001,"GRAYS HARBOR",34447,34053,68500,91,20,693,1,202,25,20,2450,3502
"198",2002,"GRAYS HARBOR",34388,34012,68400,70,22,743,4,190,26,18,2477,3550
"199",2003,"GRAYS HARBOR",34584,34216,68800,89,21,816,1,194,25,24,2553,3723
"200",2004,"GRAYS HARBOR",34780,34420,69200,107,35,818,0,255,34,30,2810,4089
"201",2005,"GRAYS HARBOR",35072,34728,69800,90,19,783,2,364,25,36,2884,4203
"202",2006,"GRAYS HARBOR",35363,35037,70400,78,9,646,3,252,17,25,1958,2988
"203",2007,"GRAYS HARBOR",35554,35246,70800,71,14,777,2,271,18,30,1814,2997
"204",2008,"GRAYS HARBOR",35594,35306,70900,80,10,551,2,151,12,26,1673,2505
"205",2009,"GRAYS HARBOR",35736,35464,71200,87,21,566,0,171,22,52,1661,2580
"206",2010,"GRAYS HARBOR",35933,35667,71600,83,24,713,1,146,14,34,1815,2830
"207",2011,"GRAYS HARBOR",35487,37413,72900,80,7,578,3,152,27,27,1660,2534
"208",2012,"GRAYS HARBOR",35602,37548,73150,0,0,0,0,0,0,0,0,0
"209",2013,"GRAYS HARBOR",35620,37580,73200,0,0,0,0,0,0,0,0,0
"210",2014,"GRAYS HARBOR",35619,37681,73300,0,0,0,0,0,0,0,0,0
"211",2000,"ISLAND",35712,35846,71558,27,6,337,1,66,24,7,1029,1497
"212",2001,"ISLAND",36132,36268,72400,24,1,128,1,32,25,14,585,810
"213",2002,"ISLAND",36487,36613,73100,17,6,151,0,28,14,8,543,767
"214",2003,"ISLAND",36938,37062,74000,19,7,171,0,39,17,6,576,835
"215",2004,"ISLAND",37334,37466,74800,29,8,154,1,27,13,4,514,750
"216",2005,"ISLAND",37926,38074,76000,36,7,620,1,171,39,10,1399,2283
"217",2006,"ISLAND",38513,38687,77200,35,10,592,0,131,26,4,1302,2100
"218",2007,"ISLAND",39092,39308,78400,45,10,509,0,88,21,7,1274,1954
"219",2008,"ISLAND",39527,39773,79300,50,7,634,0,77,37,9,1114,1928
"220",2009,"ISLAND",40020,40280,80300,69,12,456,0,50,17,11,973,1588
"221",2010,"ISLAND",40418,40682,81100,74,5,332,0,49,17,8,779,1264
"222",2011,"ISLAND",39799,39001,78800,64,15,534,2,27,24,6,864,1536
"223",2012,"ISLAND",40096,39254,79350,0,0,0,0,0,0,0,0,0
"224",2013,"ISLAND",40293,39407,79700,0,0,0,0,0,0,0,0,0
"225",2014,"ISLAND",40436,39564,80000,0,0,0,0,0,0,0,0,0
"226",2000,"JEFFERSON",13257,13042,26299,46,2,229,1,50,6,6,578,918
"227",2001,"JEFFERSON",13326,13120,26446,40,12,181,0,35,10,1,512,791
"228",2002,"JEFFERSON",13400,13200,26600,33,9,195,2,34,7,1,476,757
"229",2003,"JEFFERSON",13446,13254,26700,26,8,172,1,26,19,4,554,810
"230",2004,"JEFFERSON",13592,13408,27000,30,6,270,0,41,13,2,655,1017
"231",2005,"JEFFERSON",13886,13714,27600,52,8,322,0,42,19,3,747,1193
"232",2006,"JEFFERSON",14182,14018,28200,49,2,329,0,34,6,13,686,1119
"233",2007,"JEFFERSON",14373,14227,28600,65,1,233,0,36,6,6,638,985
"234",2008,"JEFFERSON",14463,14337,28800,44,5,234,0,19,8,0,556,866
"235",2009,"JEFFERSON",14553,14447,29000,45,5,156,2,16,3,5,478,710
"236",2010,"JEFFERSON",14696,14604,29300,49,3,192,1,29,6,5,491,776
"237",2011,"JEFFERSON",15160,14890,30050,27,3,164,0,25,14,5,440,678
"238",2012,"JEFFERSON",15231,14944,30175,0,0,0,0,0,0,0,0,0
"239",2013,"JEFFERSON",15285,14990,30275,0,0,0,0,0,0,0,0,0
"240",2014,"JEFFERSON",15503,15197,30700,0,0,0,0,0,0,0,0,0
"241",2000,"KING",872577,864457,1737034,4087,765,14342,58,16751,663,2652,60966,100284
"242",2001,"KING",883159,875141,1758300,4013,771,14897,60,18293,594,2624,61135,102387
"243",2002,"KING",891125,883187,1774312,3913,762,16194,62,18301,569,2563,60870,103234
"244",2003,"KING",893648,885652,1779300,3847,789,17821,71,19116,651,2613,61913,106821
"245",2004,"KING",898117,890183,1788300,3519,774,18156,57,19939,673,2708,61252,107078
"246",2005,"KING",908053,900247,1808300,4003,751,17156,55,21883,663,2689,65067,112267
"247",2006,"KING",921410,913890,1835300,3936,834,17822,68,18806,646,2986,58096,103194
"248",2007,"KING",934246,927054,1861300,3560,583,15565,59,13979,556,2738,53643,90683
"249",2008,"KING",945540,938660,1884200,3097,412,15697,64,9435,544,2808,51376,83433
"250",2009,"KING",958010,951290,1909300,3510,482,16043,47,8008,545,3042,56638,88315
"251",2010,"KING",970060,963340,1933400,3418,409,16047,41,9097,585,2562,53948,86107
"252",2011,"KING",974814,967786,1942600,3647,335,16907,36,9031,565,2528,51843,84892
"253",2012,"KING",981590,975410,1957000,941,158,7454,23,3505,321,737,16124,29263
"254",2013,"KING",993670,988230,1981900,470,117,4942,9,2207,214,355,10437,18751
"255",2014,"KING",1011203,1006047,2017250,547,127,4677,12,2413,229,408,10896,19309
"256",2000,"KITSAP",114459,117510,231969,689,81,2164,8,443,178,127,6422,10112
"257",2001,"KITSAP",115143,118257,233400,635,82,1935,6,674,197,114,5599,9242
"258",2002,"KITSAP",115764,118936,234700,622,76,2039,1,708,185,116,5476,9223
"259",2003,"KITSAP",116876,120124,237000,708,42,1735,6,583,175,104,4715,8068
"260",2004,"KITSAP",118080,121420,239500,701,68,1710,1,625,231,125,4543,8004
"261",2005,"KITSAP",118481,121919,240400,682,56,1819,8,586,211,119,4572,8053
"262",2006,"KITSAP",119896,123504,243400,655,72,1742,3,601,231,125,4178,7607
"263",2007,"KITSAP",120533,124267,244800,743,64,1567,1,380,200,105,4314,7374
"264",2008,"KITSAP",121483,125317,246800,791,60,1676,5,313,195,112,4416,7568
"265",2009,"KITSAP",121861,125739,247600,783,68,1490,4,346,166,107,4266,7230
"266",2010,"KITSAP",122199,126101,248300,718,58,1656,2,362,164,115,4438,7513
"267",2011,"KITSAP",125350,128550,253900,541,34,1984,3,568,123,115,4766,8134
"268",2012,"KITSAP",125774,128726,254500,0,0,0,0,0,0,0,0,0
"269",2013,"KITSAP",125538,128462,254000,0,0,0,0,0,0,0,0,0
"270",2014,"KITSAP",126451,129449,255900,0,0,0,0,0,0,0,0,0
"271",2000,"KITTITAS",16787,16575,33362,38,4,368,1,78,15,7,1402,1913
"272",2001,"KITTITAS",17110,16890,34000,31,20,439,0,69,15,5,1626,2205
"273",2002,"KITTITAS",17511,17289,34800,30,21,411,2,89,20,6,1381,1960
"274",2003,"KITTITAS",17706,17494,35200,31,13,395,0,74,20,5,1428,1966
"275",2004,"KITTITAS",18005,17795,35800,33,27,522,0,119,15,10,1610,2336
"276",2005,"KITTITAS",18404,18196,36600,39,4,486,0,112,22,5,1674,2342
"277",2006,"KITTITAS",18799,18601,37400,24,0,408,0,98,17,10,1562,2119
"278",2007,"KITTITAS",19246,19054,38300,35,7,407,0,87,17,11,1405,1969
"279",2008,"KITTITAS",19791,19609,39400,45,7,412,0,101,28,3,1348,1944
"280",2009,"KITTITAS",20036,19864,39900,44,6,389,0,80,16,11,1238,1784
"281",2010,"KITTITAS",20330,20170,40500,22,9,389,0,92,23,11,1309,1855
"282",2011,"KITTITAS",20308,20992,41300,33,7,360,2,69,16,10,1135,1632
"283",2012,"KITTITAS",20418,21082,41500,0,0,0,0,0,0,0,0,0
"284",2013,"KITTITAS",20604,21296,41900,0,0,0,0,0,0,0,0,0
"285",2014,"KITTITAS",20692,21408,42100,0,0,0,0,0,0,0,0,0
"286",2000,"KLICKITAT",9606,9555,19161,42,7,119,0,25,3,2,338,536
"287",2001,"KLICKITAT",9669,9631,19300,35,1,124,2,36,3,1,344,546
"288",2002,"KLICKITAT",9665,9635,19300,39,4,143,0,45,2,2,366,601
"289",2003,"KLICKITAT",9661,9639,19300,20,1,84,0,23,3,1,211,343
"290",2004,"KLICKITAT",9657,9643,19300,29,3,209,0,30,5,0,299,575
"291",2005,"KLICKITAT",9751,9749,19500,12,3,258,1,51,1,2,224,552
"292",2006,"KLICKITAT",9897,9903,19800,16,1,134,0,52,1,4,200,408
"293",2007,"KLICKITAT",9941,9959,19900,14,7,173,1,56,0,1,241,493
"294",2008,"KLICKITAT",10035,10065,20100,19,1,160,0,50,1,3,185,419
"295",2009,"KLICKITAT",10080,10120,20200,14,5,204,1,56,0,0,179,459
"296",2010,"KLICKITAT",10224,10276,20500,15,0,169,0,48,1,0,197,430
"297",2011,"KLICKITAT",10135,10365,20500,13,2,80,0,26,0,0,153,274
"298",2012,"KLICKITAT",10172,10428,20600,0,0,0,0,0,0,0,0,0
"299",2013,"KLICKITAT",10232,10468,20700,0,0,0,0,0,0,0,0,0
"300",2014,"KLICKITAT",10317,10533,20850,0,0,0,0,0,0,0,0,0
"301",2000,"LEWIS",34595,34005,68600,133,20,737,7,185,45,32,2122,3281
"302",2001,"LEWIS",35035,34465,69500,157,21,643,1,164,47,27,1982,3042
"303",2002,"LEWIS",35382,34818,70200,138,20,630,3,181,44,35,2082,3133
"304",2003,"LEWIS",35478,34922,70400,119,21,659,0,292,33,34,2071,3229
"305",2004,"LEWIS",35625,35075,70700,147,12,686,1,225,38,32,2333,3474
"306",2005,"LEWIS",36071,35529,71600,117,20,739,3,287,56,24,2292,3538
"307",2006,"LEWIS",36716,36184,72900,112,22,546,0,230,25,19,1757,2711
"308",2007,"LEWIS",37309,36791,74100,139,19,562,2,182,27,31,1958,2920
"309",2008,"LEWIS",37602,37098,74700,137,22,540,1,181,34,32,1964,2911
"310",2009,"LEWIS",37847,37353,75200,113,24,512,2,148,34,20,1533,2386
"311",2010,"LEWIS",38045,37555,75600,125,12,614,6,159,22,22,1949,2909
"312",2011,"LEWIS",37966,38034,76000,122,6,494,1,123,26,22,1342,2136
"313",2012,"LEWIS",38107,38193,76300,0,0,0,0,0,0,0,0,0
"314",2013,"LEWIS",38091,38109,76200,0,0,0,0,0,0,0,0,0
"315",2014,"LEWIS",38116,38184,76300,0,0,0,0,0,0,0,0,0
"316",2010,"WAHKIAKUM",2069,2081,4150,1,0,10,0,3,1,0,18,33
"317",2000,"LINCOLN",5134,5050,10184,9,1,60,0,7,12,1,84,174
"318",2001,"LINCOLN",5141,5059,10200,4,1,57,1,11,0,2,114,190
"319",2002,"LINCOLN",5141,5059,10200,8,1,58,1,4,5,0,167,244
"320",2003,"LINCOLN",5090,5010,10100,5,0,67,0,12,3,1,147,235
"321",2004,"LINCOLN",5139,5061,10200,6,2,79,0,14,3,0,153,257
"322",2005,"LINCOLN",5088,5012,10100,8,1,56,0,17,5,0,158,245
"323",2006,"LINCOLN",5137,5063,10200,4,0,49,0,13,4,0,200,270
"324",2007,"LINCOLN",5185,5115,10300,4,0,50,0,12,3,1,180,250
"325",2008,"LINCOLN",5233,5167,10400,8,2,56,0,3,5,1,136,211
"326",2009,"LINCOLN",5256,5194,10450,16,1,56,0,8,1,0,85,167
"327",2010,"LINCOLN",5280,5220,10500,4,3,43,0,6,2,1,111,170
"328",2011,"LINCOLN",5305,5295,10600,8,2,56,0,7,1,1,106,181
"329",2012,"LINCOLN",5340,5335,10675,0,0,0,0,0,0,0,0,0
"330",2013,"LINCOLN",5346,5329,10675,0,0,0,0,0,0,0,0,0
"331",2014,"LINCOLN",5348,5352,10700,0,0,0,0,0,0,0,0,0
"332",2000,"MASON",23869,25536,49405,84,8,806,2,180,38,20,1626,2764
"333",2001,"MASON",23957,25643,49600,90,16,820,2,227,59,13,1830,3057
"334",2002,"MASON",24055,25745,49800,88,13,755,4,263,63,20,1663,2869
"335",2003,"MASON",24249,25951,50200,94,15,742,2,301,43,22,1751,2970
"336",2004,"MASON",24540,26260,50800,105,18,787,2,319,56,19,1785,3091
"337",2005,"MASON",25069,26831,51900,99,10,1081,6,408,38,22,2060,3724
"338",2006,"MASON",25644,27456,53100,89,14,795,1,335,38,31,1706,3009
"339",2007,"MASON",26362,28238,54600,133,12,711,0,312,41,35,1811,3055
"340",2008,"MASON",27177,29123,56300,135,11,805,0,230,45,16,1487,2729
"341",2009,"MASON",27415,29385,56800,136,2,732,0,261,43,17,1426,2617
"342",2010,"MASON",27561,29539,57100,108,10,690,1,322,39,39,1542,2751
"343",2011,"MASON",29492,31608,61100,130,5,823,0,250,31,13,1415,2667
"344",2012,"MASON",29731,31719,61450,0,0,0,0,0,0,0,0,0
"345",2013,"MASON",29928,31872,61800,0,0,0,0,0,0,0,0,0
"346",2014,"MASON",30026,31974,62000,0,0,0,0,0,0,0,0,0
"347",2000,"OKANOGAN",19858,19706,39564,63,7,231,2,46,12,5,661,1027
"348",2001,"OKANOGAN",19916,19784,39700,66,8,249,0,60,11,5,652,1051
"349",2002,"OKANOGAN",19956,19844,39800,65,0,213,0,41,16,5,598,938
"350",2003,"OKANOGAN",19845,19755,39600,65,10,211,0,57,24,7,629,1003
"351",2004,"OKANOGAN",19836,19764,39600,66,8,345,3,96,17,12,716,1263
"352",2005,"OKANOGAN",19823,19777,39600,80,7,344,2,52,27,6,789,1307
"353",2006,"OKANOGAN",19911,19889,39800,82,2,258,1,68,21,8,906,1346
"354",2007,"OKANOGAN",19898,19902,39800,51,11,258,0,64,19,5,719,1127
"355",2008,"OKANOGAN",20037,20063,40100,34,2,336,0,61,12,9,658,1112
"356",2009,"OKANOGAN",20227,20273,40500,36,2,260,2,57,14,7,530,908
"357",2010,"OKANOGAN",20420,20480,40900,41,3,211,1,69,9,14,522,870
"358",2011,"OKANOGAN",20397,20803,41200,74,1,204,2,47,7,8,465,808
"359",2012,"OKANOGAN",20495,20930,41425,0,0,0,0,0,0,0,0,0
"360",2013,"OKANOGAN",20546,20954,41500,0,0,0,0,0,0,0,0,0
"361",2014,"OKANOGAN",20599,21101,41700,0,0,0,0,0,0,0,0,0
"362",2000,"PACIFIC",10582,10402,20984,38,3,212,1,36,7,3,407,707
"363",2001,"PACIFIC",10586,10414,21000,47,3,228,1,34,5,1,408,727
"364",2002,"PACIFIC",10585,10415,21000,42,0,230,0,25,9,5,361,672
"365",2003,"PACIFIC",10534,10366,20900,26,1,267,1,45,9,3,498,850
"366",2004,"PACIFIC",10583,10417,21000,37,6,365,0,44,4,4,513,973
"367",2005,"PACIFIC",10731,10569,21300,35,4,307,2,64,5,4,608,1029
"368",2006,"PACIFIC",10828,10672,21500,28,2,307,1,52,7,3,466,866
"369",2007,"PACIFIC",10874,10726,21600,22,1,231,0,53,6,2,390,705
"370",2008,"PACIFIC",10971,10829,21800,42,5,241,0,32,6,2,383,711
"371",2009,"PACIFIC",10969,10831,21800,44,2,212,2,18,10,1,300,589
"372",2010,"PACIFIC",11120,10980,22100,25,5,250,0,33,6,3,363,685
"373",2011,"PACIFIC",10420,10480,20900,14,1,221,1,19,8,1,275,540
"374",2012,"PACIFIC",10421,10549,20970,0,0,0,0,0,0,0,0,0
"375",2013,"PACIFIC",10430,10570,21000,0,0,0,0,0,0,0,0,0
"376",2014,"PACIFIC",10465,10635,21100,0,0,0,0,0,0,0,0,0
"377",2011,"WAHKIAKUM",1990,2010,4000,6,1,3,0,0,0,0,9,19
"378",2000,"PEND OREILLE",5851,5881,11732,9,1,118,0,19,5,2,249,403
"379",2001,"PEND OREILLE",5879,5921,11800,27,0,103,1,35,6,2,299,473
"380",2002,"PEND OREILLE",5873,5927,11800,14,2,119,0,20,3,4,245,407
"381",2003,"PEND OREILLE",5868,5932,11800,24,1,105,1,39,2,1,309,482
"382",2004,"PEND OREILLE",5912,5988,11900,14,0,172,0,31,3,0,282,502
"383",2005,"PEND OREILLE",6056,6144,12200,14,2,148,0,38,3,1,358,564
"384",2006,"PEND OREILLE",6101,6199,12300,4,2,147,1,29,2,0,325,510
"385",2007,"PEND OREILLE",6244,6356,12600,3,0,93,1,26,1,1,294,419
"386",2008,"PEND OREILLE",6338,6462,12800,4,0,107,0,30,1,2,257,401
"387",2009,"PEND OREILLE",6383,6517,12900,4,1,82,0,21,1,0,234,343
"388",2010,"PEND OREILLE",6476,6624,13100,16,2,140,0,39,0,0,243,440
"389",2011,"PEND OREILLE",6403,6597,13000,16,0,133,0,26,1,0,252,428
"390",2012,"PEND OREILLE",6464,6636,13100,0,0,0,0,0,0,0,0,0
"391",2013,"PEND OREILLE",6496,6654,13150,0,0,0,0,0,0,0,0,0
"392",2014,"PEND OREILLE",6514,6696,13210,0,0,0,0,0,0,0,0,0
"393",2000,"PIERCE",352263,348557,700820,2965,307,8276,33,6166,341,1205,27476,46769
"394",2001,"PIERCE",358513,354887,713400,2218,243,7230,33,6488,333,1199,25270,43014
"395",2002,"PIERCE",364294,360704,724998,2475,282,7541,29,6358,402,1098,26427,44612
"396",2003,"PIERCE",368647,365053,733700,2643,231,7610,27,5944,344,1165,24253,42217
"397",2004,"PIERCE",373779,370221,744000,2435,234,8130,26,6365,385,1185,24006,42766
"398",2005,"PIERCE",379689,376211,755900,2607,237,8348,28,7410,331,1121,24022,44104
"399",2006,"PIERCE",388418,385082,773500,2642,268,8414,35,7087,353,1174,23276,43249
"400",2007,"PIERCE",396882,393618,790500,2692,251,7274,29,6542,297,1087,21343,39515
"401",2008,"PIERCE",404320,401080,805400,2700,228,7266,30,5359,371,1101,22461,39516
"402",2009,"PIERCE",408432,405168,813600,2589,170,7846,33,3788,339,1227,22767,38759
"403",2010,"PIERCE",408970,405630,814600,2333,167,7944,26,4100,317,1075,19484,35446
"404",2011,"PIERCE",405776,396374,802150,2114,177,7711,23,4088,296,906,19150,34465
"405",2012,"PIERCE",408993,399207,808200,45,2,209,0,117,5,15,566,959
"406",2013,"PIERCE",412199,402301,814500,0,0,0,0,0,0,0,0,0
"407",2014,"PIERCE",415657,405643,821300,0,0,0,0,0,0,0,0,0
"408",2000,"SAN JUAN",7217,6860,14077,6,1,64,0,12,0,0,144,227
"409",2001,"SAN JUAN",7380,7020,14400,4,0,73,0,15,0,1,151,244
"410",2002,"SAN JUAN",7477,7123,14600,7,3,45,1,7,0,0,154,217
"411",2003,"SAN JUAN",7574,7226,14800,6,1,74,0,13,4,0,135,233
"412",2012,"SAN JUAN",8186,7739,15925,0,0,0,0,0,0,0,0,0
"413",2004,"SAN JUAN",7722,7378,15100,5,1,54,0,16,1,1,164,242
"414",2005,"SAN JUAN",7920,7580,15500,6,2,103,0,22,3,0,161,297
"415",2006,"SAN JUAN",8016,7684,15700,4,0,64,0,23,3,2,161,257
"416",2007,"SAN JUAN",8109,7791,15900,6,2,60,0,24,2,1,136,231
"417",2008,"SAN JUAN",8202,7898,16100,6,1,86,1,18,0,0,152,264
"418",2009,"SAN JUAN",8295,8005,16300,7,1,90,0,14,2,0,166,280
"419",2010,"SAN JUAN",8389,8111,16500,10,5,66,0,12,4,0,105,202
"420",2011,"SAN JUAN",8168,7732,15900,17,4,52,1,14,1,0,111,200
"421",2013,"SAN JUAN",8227,7773,16000,0,0,0,0,0,0,0,0,0
"422",2014,"SAN JUAN",8282,7818,16100,0,0,0,0,0,0,0,0,0
"423",2000,"SKAGIT",51997,50982,102979,62,32,998,4,317,36,39,4615,6103
"424",2001,"SKAGIT",52545,51555,104100,75,34,1007,3,328,51,43,4940,6481
"425",2002,"SKAGIT",53040,52060,105100,93,34,1105,4,407,61,39,5018,6761
"426",2003,"SKAGIT",53840,52860,106700,105,46,1367,1,424,74,47,5153,7217
"427",2004,"SKAGIT",54892,53908,108800,150,38,1288,2,464,67,62,5721,7792
"428",2005,"SKAGIT",55933,54967,110900,126,56,1592,3,587,60,52,6229,8705
"429",2006,"SKAGIT",57022,56078,113100,126,68,1150,2,529,71,60,5010,7016
"430",2007,"SKAGIT",58109,57191,115300,117,35,1183,2,480,42,67,4918,6844
"431",2008,"SKAGIT",59200,58300,117500,129,44,1069,9,342,50,55,3939,5637
"432",2009,"SKAGIT",59894,59006,118900,123,42,1012,3,266,51,54,4191,5742
"433",2010,"SKAGIT",60090,59210,119300,148,30,1144,0,215,50,54,4605,6246
"434",2011,"SKAGIT",59162,58238,117400,125,24,1180,4,256,47,64,3750,5450
"435",2012,"SKAGIT",59505,58445,117950,0,0,0,0,0,0,0,0,0
"436",2013,"SKAGIT",59833,58767,118600,0,0,0,0,0,0,0,0,0
"437",2014,"SKAGIT",60275,59225,119500,0,0,0,0,0,0,0,0,0
"438",2000,"SKAMANIA",4905,4967,9872,6,1,65,0,23,2,1,169,267
"439",2001,"SKAMANIA",4917,4983,9900,12,1,62,0,17,2,0,196,290
"440",2002,"SKAMANIA",4915,4985,9900,7,0,68,1,15,2,2,251,346
"441",2003,"SKAMANIA",4913,4987,9900,11,1,66,0,18,4,0,255,355
"442",2004,"SKAMANIA",5011,5089,10100,3,0,72,3,29,7,0,276,390
"443",2005,"SKAMANIA",5108,5192,10300,12,1,72,1,16,4,2,225,333
"444",2006,"SKAMANIA",5255,5345,10600,5,1,78,0,29,5,0,235,353
"445",2007,"SKAMANIA",5302,5398,10700,18,1,54,0,15,8,2,197,295
"446",2008,"SKAMANIA",5300,5400,10700,7,0,57,0,19,3,1,137,224
"447",2009,"SKAMANIA",5348,5452,10800,11,3,50,1,23,10,1,144,243
"448",2010,"SKAMANIA",5396,5504,10900,8,0,45,0,20,2,0,157,232
"449",2011,"SKAMANIA",5539,5611,11150,8,0,52,0,11,2,0,151,224
"450",2012,"SKAMANIA",5592,5683,11275,0,0,0,0,0,0,0,0,0
"451",2013,"SKAMANIA",5606,5694,11300,0,0,0,0,0,0,0,0,0
"452",2014,"SKAMANIA",5649,5721,11370,0,0,0,0,0,0,0,0,0
"453",2000,"SNOHOMISH",302815,303209,606024,682,158,3850,10,3150,422,322,12244,20838
"454",2001,"SNOHOMISH",309023,309577,618600,798,154,3932,12,4243,344,428,14448,24359
"455",2002,"SNOHOMISH",313678,314322,628000,789,170,3733,11,4720,291,400,13989,24103
"456",2003,"SNOHOMISH",318416,319084,637500,846,187,4114,12,4403,288,372,13884,24106
"457",2004,"SNOHOMISH",322030,322770,644800,885,204,4989,18,4825,272,417,14281,25891
"458",2005,"SNOHOMISH",327473,328327,655800,830,156,5193,14,6446,249,407,15842,29137
"459",2006,"SNOHOMISH",335384,336416,671800,770,158,4678,14,6148,225,487,15889,28369
"460",2007,"SNOHOMISH",342569,343731,686300,785,154,5001,17,4973,278,498,15497,27203
"461",2008,"SNOHOMISH",347696,348904,696600,857,136,4289,7,2874,230,488,13754,22635
"462",2009,"SNOHOMISH",351542,352758,704300,919,144,4834,17,2238,198,588,14894,23832
"463",2010,"SNOHOMISH",354964,356136,711100,895,121,4298,11,2762,237,447,15352,24123
"464",2011,"SNOHOMISH",358198,358802,717000,707,109,4023,10,2078,153,327,13752,21159
"465",2012,"SNOHOMISH",360777,362123,722900,565,84,3392,7,1817,103,341,10329,16638
"466",2013,"SNOHOMISH",364381,366119,730500,677,76,4437,6,2778,128,387,13014,21503
"467",2014,"SNOHOMISH",369695,371305,741000,659,76,4734,10,3096,151,338,14555,23619
"468",2000,"SPOKANE",212801,205138,417939,1141,146,4676,12,1917,119,475,16719,25205
"469",2001,"SPOKANE",215045,207355,422400,1204,107,4926,10,2522,134,571,17057,26531
"470",2002,"SPOKANE",216676,208924,425600,1117,131,4336,20,2447,146,481,15775,24453
"471",2003,"SPOKANE",218208,210392,428600,1026,144,4677,16,2247,141,459,16850,25560
"472",2004,"SPOKANE",219934,212066,432000,1119,100,5323,16,2680,147,380,19020,28785
"473",2005,"SPOKANE",222100,214200,436300,1265,144,3952,16,2697,134,362,12660,21230
"474",2006,"SPOKANE",225859,217941,443800,1185,116,3547,17,3290,130,468,11590,20343
"475",2007,"SPOKANE",229581,221619,451200,1352,127,3343,14,2742,119,496,11082,19275
"476",2008,"SPOKANE",233512,225488,459000,1203,101,3654,19,2231,136,559,11707,19610
"477",2009,"SPOKANE",236550,228450,465000,1107,101,4064,10,2260,116,538,13730,21926
"478",2010,"SPOKANE",239253,231047,470300,950,59,5022,12,2818,147,526,15960,25494
"479",2011,"SPOKANE",239225,233425,472650,927,106,5254,7,2566,128,582,16771,26341
"480",2012,"SPOKANE",240329,235271,475600,921,100,5962,17,2856,131,639,18489,29115
"481",2013,"SPOKANE",242482,237518,480000,953,80,5813,16,3154,154,640,19665,30475
"482",2014,"SPOKANE",244584,239916,484500,884,95,5336,14,3043,190,537,18640,28739
"483",2000,"STATE",2959821,2934300,5894121,12891,2155,52422,193,34404,2659,5739,187964,298427
"484",2001,"STATE",2999785,2975115,5974900,12380,2083,52230,177,38444,2586,5864,192070,305834
"485",2002,"STATE",3032934,3008776,6041710,12079,2082,53885,183,39773,2674,5720,189510,305906
"486",2003,"STATE",3061091,3037209,6098300,12412,2143,57616,182,40351,2778,5700,190835,312023
"487",2004,"STATE",3095563,3072237,6167800,12227,2144,59985,189,43070,2828,5849,195546,321838
"488",2005,"STATE",3139377,3117023,6256400,12879,2051,60099,204,49151,2772,5774,197020,329950
"489",2006,"STATE",3198249,3177351,6375600,12628,2079,57338,188,44967,2672,6354,180121,306347
"490",2007,"STATE",3253804,3234196,6488000,12658,1877,51863,177,36932,2556,6018,168457,280538
"491",2008,"STATE",3303082,3284518,6587600,12228,1565,51385,187,27730,2578,6206,162276,264155
"492",2009,"STATE",3343103,3325097,6668200,12576,1560,52379,186,23277,2495,6662,167152,266287
"493",2010,"STATE",3375574,3357676,6733250,12070,1315,54421,154,25282,2499,5876,166485,268102
"494",2011,"STATE",3396249,3371651,6767900,11647,1263,54833,159,24114,2217,5545,159218,258996
"495",2012,"STATE",3420988,3396782,6817770,2900,360,18311,57,8584,657,1799,49449,82117
"496",2013,"STATE",3453072,3429328,6882400,2215,283,15609,31,8224,526,1394,43944,72226
"497",2014,"STATE",3495753,3472417,6968170,2090,298,14747,36,8552,570,1283,44091,71667
"498",2000,"STEVENS",20126,19940,40066,19,3,234,7,31,5,1,761,1061
"499",2001,"STEVENS",20233,20067,40300,11,1,237,1,48,8,1,639,946
"500",2002,"STEVENS",20275,20125,40400,13,1,224,2,61,3,4,671,979
"501",2003,"STEVENS",20367,20233,40600,62,2,346,6,70,14,4,731,1235
"502",2004,"STEVENS",20408,20292,40700,12,5,317,1,77,24,3,768,1207
"503",2005,"STEVENS",20647,20553,41200,29,2,404,1,87,17,9,789,1338
"504",2006,"STEVENS",21087,21013,42100,33,1,395,1,112,15,8,577,1142
"505",2007,"STEVENS",21524,21476,43000,27,2,305,1,82,12,4,675,1108
"506",2008,"STEVENS",21862,21838,43700,20,3,304,1,67,18,7,651,1071
"507",2009,"STEVENS",22001,21999,44000,33,2,287,1,78,20,6,604,1031
"508",2010,"STEVENS",22140,22160,44300,27,1,405,0,105,20,8,633,1199
"509",2011,"STEVENS",21772,21828,43600,23,0,262,2,66,7,5,534,899
"510",2012,"STEVENS",21871,21829,43700,0,0,0,0,0,0,0,0,0
"511",2013,"STEVENS",21913,21887,43800,0,0,0,0,0,0,0,0,0
"512",2014,"STEVENS",22003,21897,43900,0,0,0,0,0,0,0,0,0
"513",2000,"THURSTON",105812,101543,207355,332,68,1922,2,547,117,106,5481,8575
"514",2001,"THURSTON",107237,102963,210200,375,65,1823,6,667,94,100,5897,9027
"515",2002,"THURSTON",108285,104015,212300,386,55,1770,2,621,127,111,5884,8956
"516",2003,"THURSTON",109541,105259,214800,375,52,1658,4,594,108,91,5191,8073
"517",2004,"THURSTON",111405,107095,218500,408,51,1790,8,638,87,89,5838,8909
"518",2005,"THURSTON",114222,109878,224100,428,46,1793,2,814,65,101,5983,9232
"519",2006,"THURSTON",117740,113360,231100,405,36,1686,4,684,75,112,5426,8428
"520",2007,"THURSTON",121204,116796,238000,340,42,1530,7,747,68,88,5082,7904
"521",2008,"THURSTON",124873,120427,245300,428,36,1722,4,471,86,112,6119,8978
"522",2009,"THURSTON",127128,122672,249800,402,47,1634,5,527,99,110,5276,8100
"523",2010,"THURSTON",128430,123970,252400,455,41,2052,4,428,86,86,5649,8801
"524",2011,"THURSTON",130251,123849,254100,402,31,1858,4,363,66,83,4763,7570
"525",2012,"THURSTON",131574,125226,256800,146,5,883,9,222,59,60,3293,4677
"526",2013,"THURSTON",133282,126818,260100,0,0,0,0,0,0,0,0,0
"527",2014,"THURSTON",135289,128711,264000,0,0,0,0,0,0,0,0,0
"528",2000,"WAHKIAKUM",1911,1913,3824,1,0,21,0,0,0,0,48,70
"529",2001,"WAHKIAKUM",1898,1902,3800,1,1,7,0,0,2,0,40,51
"530",2002,"WAHKIAKUM",1898,1902,3800,3,1,1,1,3,0,0,36,45
"531",2003,"WAHKIAKUM",1898,1902,3800,3,0,32,0,6,0,0,41,82
"532",2004,"WAHKIAKUM",1898,1902,3800,5,0,25,0,4,3,0,44,81
"533",2005,"WAHKIAKUM",1947,1953,3900,7,0,16,0,7,1,0,20,51
"534",2006,"WAHKIAKUM",1947,1953,3900,7,0,16,0,5,1,0,17,46
"535",2007,"WAHKIAKUM",1996,2004,4000,7,0,19,0,7,2,0,21,56
"536",2008,"WAHKIAKUM",2046,2054,4100,5,0,19,0,3,0,1,28,56
"537",2009,"WAHKIAKUM",2045,2055,4100,7,2,7,0,1,1,0,7,25
"538",2012,"WAHKIAKUM",2007,2018,4025,0,0,0,0,0,0,0,0,0
"539",2013,"WAHKIAKUM",2012,2008,4020,0,0,0,0,0,0,0,0,0
"540",2014,"WAHKIAKUM",2005,2005,4010,0,0,0,0,0,0,0,0,0
"541",2007,"WHITMAN",21058,21642,42700,22,9,176,0,31,22,6,568,834
"542",2000,"WALLA WALLA",27079,28101,55180,142,6,422,0,122,51,26,1691,2460
"543",2001,"WALLA WALLA",27089,28111,55200,118,2,448,2,117,50,22,1811,2570
"544",2002,"WALLA WALLA",27189,28211,55400,96,4,396,0,89,57,22,1662,2326
"545",2003,"WALLA WALLA",27387,28413,55800,95,30,450,0,113,39,23,1772,2522
"546",2004,"WALLA WALLA",27831,28869,56700,101,21,351,0,139,44,21,1520,2197
"547",2005,"WALLA WALLA",28224,29276,57500,103,12,337,0,105,57,14,1484,2112
"548",2006,"WALLA WALLA",28410,29490,57900,104,7,323,1,86,45,14,1534,2114
"549",2007,"WALLA WALLA",28606,29694,58300,85,21,413,0,100,39,13,1671,2342
"550",2008,"WALLA WALLA",28757,29843,58600,98,11,375,1,97,36,13,1465,2096
"551",2009,"WALLA WALLA",29059,30141,59200,74,11,508,0,74,45,17,1500,2229
"552",2010,"WALLA WALLA",29266,30334,59600,94,6,375,1,79,31,26,1369,1981
"553",2011,"WALLA WALLA",28954,29846,58800,109,15,362,3,65,33,23,1509,2119
"554",2012,"WALLA WALLA",29081,30019,59100,0,0,0,0,0,0,0,0,0
"555",2013,"WALLA WALLA",29382,30118,59500,0,0,0,0,0,0,0,0,0
"556",2014,"WALLA WALLA",29719,30431,60150,0,0,0,0,0,0,0,0,0
"557",2000,"WHATCOM",84626,82188,166814,213,28,1525,5,395,81,73,5395,7715
"558",2001,"WHATCOM",86534,84066,170600,220,32,1461,1,460,87,77,6420,8758
"559",2002,"WHATCOM",87328,84872,172200,220,47,1672,4,536,98,89,6293,8959
"560",2003,"WHATCOM",88471,86029,174500,225,60,1951,3,506,108,83,6238,9180
"561",2004,"WHATCOM",89873,87427,177300,247,51,1785,4,640,90,96,6985,9898
"562",2005,"WHATCOM",91621,89179,180800,260,56,1754,5,596,72,82,7174,9999
"563",2006,"WHATCOM",93358,90942,184300,257,41,1818,1,518,76,98,6504,9313
"564",2007,"WHATCOM",95355,92945,188300,269,55,1498,2,436,87,81,6232,8660
"565",2008,"WHATCOM",96686,94314,191000,285,44,1458,2,374,71,87,5361,7682
"566",2009,"WHATCOM",97717,95383,193100,270,34,1401,8,266,76,90,5330,7475
"567",2010,"WHATCOM",98900,96600,195500,344,11,1426,5,266,90,104,4973,7219
"568",2011,"WHATCOM",101969,100131,202100,275,25,1436,3,229,97,74,4708,6847
"569",2012,"WHATCOM",102608,100892,203500,282,11,411,1,67,38,7,648,1465
"570",2013,"WHATCOM",103658,102142,205800,115,10,417,0,85,30,12,828,1497
"571",2014,"WHATCOM",104555,103045,207600,0,0,0,0,0,0,0,0,0
"572",2000,"WHITMAN",20123,20617,40740,38,10,223,0,34,21,5,665,996
"573",2001,"WHITMAN",19909,20391,40300,28,19,212,0,31,32,7,741,1070
"574",2002,"WHITMAN",20054,20546,40600,48,7,256,0,45,15,8,881,1260
"575",2003,"WHITMAN",20239,20761,41000,28,11,257,0,39,25,4,798,1162
"576",2004,"WHITMAN",20580,21120,41700,27,24,212,0,59,16,6,706,1050
"577",2005,"WHITMAN",20921,21479,42400,32,8,167,3,33,20,4,568,835
"578",2006,"WHITMAN",21107,21693,42800,40,11,156,0,29,19,3,621,879
"579",2008,"WHITMAN",21202,21798,43000,21,10,176,0,20,10,2,455,694
"580",2009,"WHITMAN",21348,21952,43300,36,7,133,0,25,14,3,508,726
"581",2010,"WHITMAN",21489,22111,43600,31,3,264,1,35,17,12,605,968
"582",2011,"WHITMAN",21979,22821,44800,36,9,154,0,23,10,3,562,797
"583",2012,"WHITMAN",22671,23279,45950,0,0,0,0,0,0,0,0,0
"584",2013,"WHITMAN",22665,23335,46000,0,0,0,0,0,0,0,0,0
"585",2014,"WHITMAN",22887,23613,46500,0,0,0,0,0,0,0,0,0
"586",2000,"YAKIMA",111491,111090,222581,368,110,3052,14,1210,96,171,8586,13607
"587",2001,"YAKIMA",112430,112070,224500,320,116,3194,10,1126,109,163,8250,13288
"588",2002,"YAKIMA",112674,112326,225000,315,143,3487,10,1364,121,175,8847,14462
"589",2003,"YAKIMA",113180,112820,226000,372,170,3418,10,1365,137,194,8947,14613
"590",2004,"YAKIMA",113933,113567,227500,366,152,3109,10,1483,122,181,9218,14641
"591",2005,"YAKIMA",114828,114472,229300,390,158,3824,22,2176,129,218,10179,17096
"592",2006,"YAKIMA",116058,115742,231800,387,117,3518,10,2176,126,233,9280,15847
"593",2007,"YAKIMA",117246,116954,234200,535,154,3063,15,1871,136,212,7629,13615
"594",2008,"YAKIMA",118093,117807,235900,417,124,3057,19,1814,100,244,7344,13119
"595",2009,"YAKIMA",119350,119050,238400,457,93,3193,22,1505,120,230,6160,11780
"596",2010,"YAKIMA",119716,119384,239100,465,82,3354,24,1218,108,233,6560,12044
"597",2011,"YAKIMA",122280,122420,244700,449,80,3351,16,1264,107,236,5801,11304
"598",2012,"YAKIMA",123199,122801,246000,0,0,0,0,0,0,0,0,0
"599",2013,"YAKIMA",124171,123079,247250,0,0,0,0,0,0,0,0,0
"600",2014,"YAKIMA",125028,123772,248800,0,0,0,0,0,0,0,0,0
